{
  "levelOneLocationMatrix": [
    [0,0,0,0,0,3,0,0,0,0,0,0],
    [0,0,0,0,0,0,0,0,0,0,0,0],
    [0,0,0,0,3,3,3,0,0,0,0,0],
    [0,0,0,0,3,1,3,0,0,0,0,0],
    [0,0,0,0,3,2,3,0,0,0,0,0],
    [0,0,0,0,3,0,3,0,0,0,0,0],
    [0,0,0,0,3,0,3,0,0,0,0,0],
    [0,0,0,0,3,3,3,0,0,0,0,0],
    [0,0,0,0,0,0,0,0,0,0,0,0],
    [0,0,0,0,0,0,0,0,0,0,0,0],
    [0,0,0,0,0,0,0,0,0,0,0,0],
    [0,0,0,0,0,0,0,0,0,0,0,0]
  ],
  "levelOneGoalMatrix": [
    [0,0,0,0,0,0,0,0,0,0,0,0],
    [0,0,0,0,0,0,0,0,0,0,0,0],
    [0,0,0,0,0,0,0,0,0,0,0,0],
    [0,0,0,0,0,0,0,0,0,0,0,0],
    [0,0,0,0,0,0,0,0,0,0,0,0],
    [0,0,0,0,0,0,0,0,0,0,0,0],
    [0,0,0,0,0,4,0,0,0,0,0,0],
    [0,0,0,0,0,0,0,0,0,0,0,0],
    [0,0,0,0,0,0,0,0,0,0,0,0],
    [0,0,0,0,0,0,0,0,0,0,0,0],
    [0,0,0,0,0,0,0,0,0,0,0,0],
    [0,0,0,0,0,0,0,0,0,0,0,0]
  ],
  "levelTwoLocationMatrix": [
    [0,0,0,0,0,0,0,0,0,0,0,0],
    [0,0,0,0,0,3,0,0,0,0,0,0],
    [0,0,0,0,3,1,3,0,0,0,0,0],
    [0,0,0,3,3,2,3,0,0,0,0,0],
    [0,0,0,3,0,0,3,3,0,0,0,0],
    [0,0,0,3,0,0,0,3,0,0,0,0],
    [0,0,0,3,3,0,3,3,0,0,0,0],
    [0,0,0,0,3,2,3,0,0,0,0,0],
    [0,0,0,0,3,0,3,0,0,0,0,0],
    [0,0,0,0,3,3,3,0,0,0,0,0],
    [0,0,0,0,0,0,0,0,0,0,0,0],
    [0,0,0,0,0,0,0,0,0,0,0,0]
  ],
  "levelTwoGoalMatrix": [
    [0,0,0,0,0,0,0,0,0,0,0,0],
    [0,0,0,0,0,0,0,0,0,0,0,0],
    [0,0,0,0,0,0,0,0,0,0,0,0],
    [0,0,0,0,0,0,0,0,0,0,0,0],
    [0,0,0,0,0,0,0,0,0,0,0,0],
    [0,0,0,0,0,0,4,0,0,0,0,0],
    [0,0,0,0,0,0,0,0,0,0,0,0],
    [0,0,0,0,0,0,0,0,0,0,0,0],
    [0,0,0,0,0,4,0,0,0,0,0,0],
    [0,0,0,0,0,0,0,0,0,0,0,0],
    [0,0,0,0,0,0,0,0,0,0,0,0],
    [0,0,0,0,0,0,0,0,0,0,0,0]
  ],
  "levelThreeLocationMatrix": [
    [0,0,0,0,0,0,0,0,0,0,0,0],
    [0,0,0,0,0,0,0,0,0,0,0,0],
    [0,0,0,3,3,3,3,3,3,0,0,0],
    [0,0,0,3,0,0,0,0,3,0,0,0],
    [0,0,0,3,1,3,0,2,3,0,0,0],
    [0,0,0,3,0,0,2,0,3,0,0,0],
    [0,0,0,3,0,3,2,0,3,0,0,0],
    [0,0,0,3,0,0,0,0,3,0,0,0],
    [0,0,0,3,3,3,3,3,3,0,0,0],
    [0,0,0,0,0,0,0,0,0,0,0,0],
    [0,0,0,0,0,0,0,0,0,0,0,0],
    [0,0,0,0,0,0,0,0,0,0,0,0]
  ],
  "levelThreeGoalMatrix": [
    [0,0,0,0,0,0,0,0,0,0,0,0],
    [0,0,0,0,0,0,0,0,0,0,0,0],
    [0,0,0,0,0,0,0,0,0,0,0,0],
    [0,0,0,0,0,0,4,0,0,0,0,0],
    [0,0,0,0,0,0,0,4,0,0,0,0],
    [0,0,0,0,0,0,0,0,0,0,0,0],
    [0,0,0,0,0,0,4,0,0,0,0,0],
    [0,0,0,0,0,0,0,0,0,0,0,0],
    [0,0,0,0,0,0,0,0,0,0,0,0],
    [0,0,0,0,0,0,0,0,0,0,0,0],
    [0,0,0,0,0,0,0,0,0,0,0,0],
    [0,0,0,0,0,0,0,0,0,0,0,0]
  ],
  "levelFourLocationMatrix": [
    [0,0,0,0,0,0,0,0,0,0,0,0],
    [0,0,0,0,3,3,3,3,3,0,0,0],
    [0,0,3,3,3,0,0,0,3,0,0,0],
    [0,0,3,0,1,2,0,0,3,0,0,0],
    [0,0,3,3,3,0,2,0,3,0,0,0],
    [0,0,3,0,3,3,2,0,3,0,0,0],
    [0,0,3,0,3,0,0,0,3,3,0,0],
    [0,0,3,0,0,2,2,2,0,3,0,0],
    [0,0,3,0,0,0,0,0,0,3,0,0],
    [0,0,3,3,3,3,3,3,3,3,0,0],
    [0,0,0,0,0,0,0,0,0,0,0,0],
    [0,0,0,0,0,0,0,0,0,0,0,0]
  ],
  "levelFourGoalMatrix": [
    [0,0,0,0,0,0,0,0,0,0,0,0],
    [0,0,0,0,0,0,0,0,0,0,0,0],
    [0,0,0,0,0,0,0,0,0,0,0,0],
    [0,0,0,4,0,0,0,0,0,0,0,0],
    [0,0,0,0,0,0,0,4,0,0,0,0],
    [0,0,0,4,0,0,0,0,0,0,0,0],
    [0,0,0,0,0,0,4,0,0,0,0,0],
    [0,0,0,0,0,0,0,0,4,0,0,0],
    [0,0,0,0,0,0,4,0,0,0,0,0],
    [0,0,0,0,0,0,0,0,0,0,0,0],
    [0,0,0,0,0,0,0,0,0,0,0,0],
    [0,0,0,0,0,0,0,0,0,0,0,0]
  ]
}

